{	
	"w":20,
	"h": 30,
	"data": [
		1,0,0,0,0,0,0,0,0,0,0,0,0,0,0,0,0,0,0,1,
		1,0,0,0,0,0,0,0,0,0,0,0,0,0,0,0,0,0,0,1,
		1,0,0,0,0,0,0,0,0,0,0,0,0,0,0,0,0,0,0,1,
		1,0,0,0,0,0,0,0,0,0,0,0,0,0,0,0,0,0,0,1,
		1,0,0,0,0,0,0,0,0,0,0,0,0,0,0,0,0,0,0,1,
		1,0,0,0,0,0,0,0,0,0,0,0,0,0,0,0,0,0,0,1,
		1,0,0,0,0,0,0,0,0,0,0,0,0,0,0,0,0,0,0,1,
		1,0,0,0,0,0,0,0,0,0,0,0,0,0,0,0,0,0,0,1,
		1,0,0,0,0,0,0,0,0,0,0,0,0,0,0,0,0,0,0,1,
		1,0,0,0,0,0,0,0,0,0,0,0,0,0,0,0,0,0,0,1,
		1,0,0,0,0,0,0,0,0,0,0,1,0,0,0,0,0,0,0,1,
		1,0,0,0,0,0,0,0,0,0,0,1,0,0,0,0,0,0,0,1,
		1,0,0,0,0,0,0,0,0,0,0,1,0,0,0,0,0,0,0,1,
		1,0,0,0,1,0,0,0,0,0,0,1,0,0,0,0,0,0,0,1,
		1,0,0,0,1,0,0,0,0,0,0,1,0,0,0,0,0,0,0,1,
		1,0,0,0,1,0,0,0,0,0,0,1,0,0,0,0,0,0,0,1,
		1,0,0,0,1,0,0,0,0,0,0,1,0,0,0,0,0,0,0,1,
		1,0,0,0,1,0,0,0,0,0,0,0,0,0,0,0,0,0,0,1,
		1,0,0,0,1,0,0,0,0,0,0,0,0,0,0,0,0,0,0,1,
		1,0,0,0,1,1,0,0,0,0,0,0,0,0,0,0,0,0,0,1,
		1,0,0,0,0,0,0,0,0,0,0,0,0,0,0,0,0,0,0,1,
		1,0,0,0,0,0,0,0,0,0,0,0,0,0,0,0,0,0,0,1,
		1,0,0,0,0,0,0,0,0,0,0,0,0,0,0,0,0,0,0,1,
		1,0,0,0,0,0,0,0,0,0,0,0,0,0,0,0,0,0,0,1,
		1,0,0,0,0,0,0,0,0,0,0,0,0,0,0,0,0,0,0,1,
		1,0,0,0,0,0,0,0,0,0,0,0,0,0,0,0,0,0,0,1,
		1,0,0,0,0,0,0,0,0,0,0,0,0,0,0,0,0,0,0,1,
		1,0,0,0,0,0,0,0,0,0,0,0,0,0,0,0,0,0,0,1,
		1,0,0,0,0,0,0,0,0,0,0,0,0,0,0,0,0,0,0,1,
		1,0,0,0,0,0,0,0,0,0,0,0,0,0,0,0,0,0,0,1
	]
}