{	
	"w":16,
	"h": 24,
	"data": [
		1,0,0,0,0,0,0,0,0,0,0,0,0,0,0,1,
		1,0,0,0,0,0,0,0,0,0,0,0,0,0,0,1,
		1,0,0,0,0,0,0,0,0,0,0,0,0,0,0,1,
		1,0,0,0,0,0,0,0,0,0,0,0,0,0,0,1,
		1,0,0,0,0,0,0,0,0,0,0,0,0,0,0,1,
		1,0,0,0,0,0,0,0,0,0,0,0,0,0,0,1,
		1,0,0,0,0,0,0,0,0,0,0,0,0,0,0,1,
		1,0,0,0,0,0,0,0,0,0,0,1,0,0,0,1,
		1,0,0,0,0,0,0,0,0,0,0,1,0,0,0,1,
		1,0,0,0,0,0,0,0,0,0,0,1,0,0,0,1,
		1,0,0,0,1,0,0,0,0,0,0,1,0,0,0,1,
		1,0,0,0,1,0,0,0,0,0,0,1,0,0,0,1,
		1,0,0,0,1,0,0,0,0,0,0,1,0,0,0,1,
		1,0,0,0,1,0,0,0,0,0,0,1,0,0,0,1,
		1,0,0,0,1,0,0,0,0,0,0,0,0,0,0,1,
		1,0,0,0,1,0,0,0,0,0,0,0,0,0,0,1,
		1,0,0,0,1,1,0,0,0,0,0,0,0,0,0,1,
		1,0,0,0,0,0,0,0,0,0,0,0,0,0,0,1,
		1,0,0,0,0,0,0,0,0,0,0,0,0,0,0,1,
		1,0,0,0,0,0,0,0,0,0,0,0,0,0,0,1,
		1,0,0,0,0,0,0,0,0,0,0,0,0,0,0,1,
		1,0,0,0,0,0,0,0,0,0,0,0,0,0,0,1,
		1,0,0,0,0,0,0,0,0,0,0,0,0,0,0,1,
		1,0,0,0,0,0,0,0,0,0,0,0,0,0,0,1
	]
}