{	
	"w": 16,
	"h": 24,
	"data": [
		255,   0,   0,   0,   0,   0,   0,   0,   0,   0,   0,   0,   0,   0,   0, 255,
		255,   0,   0,   0,   0,   0,   0,   0,   0,   0,   0,   0,   0,   0,   0, 255,
		255,   0,   0,   0,   0,   0,   0,   0,   0,   0,   0,   0,   0,   0,   0, 255,
		255,   0,   0,   0,   0,   0,   0,   0,   0,   0,   0,   0,   0,   0,   0, 255,
		255,   0,   0,   0,   0,   0,   0,   0,   0,   0,   0,   0,   0,   0,   0, 255,
		255,   0,   0,   0,   0,   0,   0,   0,   0,   0,   0,   0,   0,   0,   0, 255,
		255,   0,   0,   0,   0,   0,   0,   0,   0,   0,   0,   0,   0,   0,   0, 255,
		255,   0,   0,   0,   0,   0,   0,   0,   0,   0,   0, 255,   0,   0,   0, 255,
		255,   0,   0,   0,   0,   0,   0,   0,   0,   0,   0, 255,   0,   0,   0, 255,
		255,   0,   0,   0,   0,   0,   0,   0,   0,   0,   0, 255,   0,   0,   0, 255,
		255,   0,   0,   0, 255,   0,   0,   0,   0,   0,   0, 255,   0,   0,   0, 255,
		255,   0,   0,   0, 255,   0,   0,   0,   0,   0,   0, 255,   0,   0,   0, 255,
		255,   0,   0,   0, 255,   0,   0,   0,   0,   0,   0, 255,   0,   0,   0, 255,
		255,   0,   0,   0, 255,   0,   0,   0,   0,   0,   0, 255,   0,   0,   0, 255,
		255,   0,   0,   0, 255,   0,   0,   0,   0,   0,   0,   0,   0,   0,   0, 255,
		255,   0,   0,   0, 255,   0,   0,   0,   0,   0,   0,   0,   0,   0,   0, 255,
		255,   0,   0,   0, 255,   0,   0,   0,   0,   0,   0,   0,   0,   0,   0, 255,
		255,   0,   0,   0,   0,   0,   0,   0,   0,   0,   0,   0,   0,   0,   0, 255,
		255,   0,   0,   0,   0,   0,   0,   0,   0,   0,   0,   0,   0,   0,   0, 255,
		255,   0,   0,   0,   0,   0,   0,   0,   0,   0,   0,   0,   0,   0,   0, 255,
		255,   0,   0,   0,   0,   0,   0,   0,   0,   0,   0,   0,   0,   0,   0, 255,
		255,   0,   0,   0,   0,   0,   0,   0,   0,   0,   0,   0,   0,   0,   0, 255,
		255,   0,   0,   0,   0,   0,   0,   0,   0,   0,   0,   0,   0,   0,   0, 255,
		255,   0,   0,   0,   0,   0,   0,   0,   0,   0,   0,   0,   0,   0,   0, 255
	]
}